#####################################
###....#.....#......###...#...#.....#
#S..##...##....####.....#..##.#.##..#
###########.###....##.####.##.#.#..##
E......C......##.######..#......#...#
#####.#####.#..........C.##########.#
#........C..###.#.#.##..............#
#####################################